#################################################################################################
#                                 #                               #                             #
#                                 #                               #                             #
#                                 #                               #                             #
#                                 #                               #                             #
#               #                 #                #              #                 #           #
#               #                 #                #              #                 #           #
#               #                 #                #              #                 #           #
#               #                 #                #              #                 #           #
#               #                 #                #              #                 #           #
#               #                 #                #              #                 #           #
#               #                 #                #              #                 #           #
#               #                 #                #              #                 #           #
#               #                 #                #              #                 #           #
#               #                 #                #              #                 #           #
#               #                 #                #              #                 #           #
#               #                 #                #              #                 #           #
#               #                 #                #              #                 #           #
#               #                 #                #              #                 #           #
#               #                 #                #              #                 #           #
#               #                 #                #              #                 #           #
#               #                 #                #              #                 #           #
#               #                 #                #              #                 #           #
#               #                 #                #              #                 #           #
#               #                 #                #              #                 #           #
#               #                 #                #              #                 #           #
#               #                 #                #              #                 #           #
#               #                 #                #              #                 #           #
#               #                 #                #              #                 #           #
#               #                 #                #              #                 #           #
#               #                 #                #              #                 #           #
#               #                 #                #              #                 #           #
#               #                 #                #              #                 #           #
#               #                 #                #              #                 #           #
#               #                                  #                                #           #
#               #                                  #                                #           #
#               #                                  #                                #           #
#       E       #                                  #                                #           #
#               #                                  #                                #      O    #
#               #                                  #                                #           #
#################################################################################################